NO    ./src/texture1.txt  
SO ./src/texture1.txt
WE ./src/texture1.txt
     
EA ./src/texture1.txt

C 1,1,1
F 122,122,122

111111111111111111
111111111111111111
10000000N000000011
111111111111111111